#################################################
#                                               #
#                                               #
#                                           p   #
#                                               #
#################################################