#################################################
#                                               #
#                                               #
#       g                                    p   #
#                                               #
#################################################