####################
#


#      #######
###             t
#####
#########
#####
$

####################