####################
     #

#
#      #######
###
#####
          #########
      #####


####################